Angel Flesh          - cannot be before [Demon Essence, Demon Horn, Peter Pants], cannot be after [Chaos Borage, Nether Bloom, Peter Pants]
Basilisk Nail        - cannot be before [Peter Pants], cannot be after [Basilisk Scale, Peter Pants]
Basilisk Scale       - cannot be before [Basilisk Nail, Peter Pants], cannot be after [Peter Pants]
Behemoth Claw        - cannot be before [Fatal Brick, Peter Pants], cannot be after [Roc Oil, Peter Pants]
Bloat Cabbage        - cannot be before [Mound Broadleaf, Red Blossom, Corupted Bush, Peter Pants], cannot be after [Faun Fur, Peter Pants]
Blue Buttons         - cannot be before [Eerie Buttons, Peter Pants], cannot be after [Peter Pants]
Bugbear Extract      - cannot be before [Werewolf Essence, Peter Pants], cannot be after [Centaur Shell, Humming Bush, Peter Pants]
Candied Brier        - cannot be before [Peter Pants], cannot be after [Peter Pants]
Centaur Shell        - cannot be before [Bugbear Extract, Peter Pants], cannot be after [Peter Pants]
Cerberus Collar      - cannot be before [Peter Pants], cannot be after [Wyvern Flesh, Wyvern liver, Chimera Tail, Peter Pants]
Chaos Borage         - cannot be before [Angel Flesh, Peter Pants], cannot be after [Peter Pants]
Chimera Tail         - cannot be before [Cerberus Collar, Peter Pants], cannot be after [Peter Pants]
Cinder Buxus         - cannot be before [Demon Essence, Peter Pants], cannot be after [Demon Horn, Peter Pants]
Corrupt Brittlebush  - cannot be before [Corrupted Bush, Peter Pants], cannot be after [Peter Pants]
Corrupted Bush       - cannot be before [Peter Pants], cannot be after [Bloat Cabbage, Corrupt Brittlebush, Peter Pants]
Cyclops Extract      - cannot be before [Passion Blight, Peter Pants], cannot be after [Peter Pants]
Demon Essence        - cannot be before [Peter Pants], cannot be after [Angel Flesh, Cinder Buxus, Peter Pants]
Demon Horn           - cannot be before [Cinder Buxus, Peter Pants], cannot be after [Angel Flesh, Peter Pants]
Drake Dust           - cannot be before [Minotaur Hair, Peter Pants], cannot be after [Phoenix Tongue, Peter Pants]
Dryad Heart          - cannot be before [Lover Blade, Peter Pants], cannot be after [Lover Blade, Peter Pants]
Eerie Buttons        - cannot be before [Peter Pants], cannot be after [Blue buttons, Peter Pants]
Fatal Brick          - cannot be before [Shadow Bronze, Peter Pants], cannot be after [Behemoth Claw, Peter Pants]
Faun Fur             - cannot be before [Bloat Cabbage, Peter Pants], cannot be after [Peter Pants]
Fury Boxwood         - cannot be before [Peter Pants], cannot be after [Peter Pants]
Ghost Ichor          - cannot be before [Nether Bloom, Peter Pants], cannot be after [Plague Brass, Peter Pants]
Humming Bush         - cannot be before [Bugbear Extract, Peter Pants], cannot be after [Peter Pants]
Jackalope Infusion   - cannot be before [Peter Pants], cannot be after [Peter Pants]
Lover Blade          - cannot be before [Dryad Heart, Peter Pants], cannot be after [Dryad Heart, Peter Pants]
Luminous Broadleaf   - cannot be before [Serpent Feather, Peter Pants], cannot be after [Peter Pants]
Merman Strand        - cannot be before [Peter Pants], cannot be after [Peter Pants]
Minotaur Hair        - cannot be before [Peter Pants], cannot be after [Drake Dust, Serpent Feather, Peter Pants]
Mound Broadleaf      - cannot be before [Peter Pants], cannot be after [Bloat Cabbage, Peter Pants]
Nether Bloom         - cannot be before [Angel Flesh, Peter Pants], cannot be after [Ghost Ichor, Peter Pants]
Ogre Snot            - cannot be before [Peter Pants], cannot be after [Yeti Fur, Peter Pants]
Passion Blight       - cannot be before [Peter Pants], cannot be after [Cyclops Extract, Peter Pants]
Peter Pants          - cannot be before [Angel Flesh, Basilisk Nail, Basilisk Scale, Behemoth Claw, Bloat Cabbage, Blue Buttons, Bugbear Extract, Candied Brier, Centaur Shell, Cerberus Collar, Chaos Borage, Chimera Tail, Cinder Buxus, Corrupt Brittlebush, Corrupted Bush, Cyclops Extract, Demon Essence, Demon Horn, Drake Dust, Dryad Heart, Eerie Buttons, Fatal Brick, Faun Fur, Fury Boxwood, Ghost Ichor, Humming Bush, Jackalope Infusion, Lover Blade, Luminous Broadleaf, Merman Strand, Minotaur Hair, Mound Broadleaf, Nether Bloom, Ogre Snot, Passion Blight, Peter Pants, Phoenix Tongue, Plague Brass, Red Blossom, Roc Oil, Satyr Tear, Serpent Feather, Shadow Bronze, Sphinx Tear, Tengu Sweat, Werewolf Essence, Wolpertinger Fang, Wyvern Flesh, Wyvern Liver, Yeti Fur], cannot be after [Angel Flesh, Basilisk Nail, Basilisk Scale, Behemoth Claw, Bloat Cabbage, Blue Buttons, Bugbear Extract, Candied Brier, Centaur Shell, Cerberus Collar, Chaos Borage, Chimera Tail, Cinder Buxus, Corrupt Brittlebush, Corrupted Bush, Cyclops Extract, Demon Essence, Demon Horn, Drake Dust, Dryad Heart, Eerie Buttons, Fatal Brick, Faun Fur, Fury Boxwood, Ghost Ichor, Humming Bush, Jackalope Infusion, Lover Blade, Luminous Broadleaf, Merman Strand, Minotaur Hair, Mound Broadleaf, Nether Bloom, Ogre Snot, Passion Blight, Peter Pants, Phoenix Tongue, Plague Brass, Red Blossom, Roc Oil, Satyr Tear, Serpent Feather, Shadow Bronze, Sphinx Tear, Tengu Sweat, Werewolf Essence, Wolpertinger Fang, Wyvern Flesh, Wyvern Liver, Yeti Fur]
Phoenix Tongue       - cannot be before [Drake Dust, Peter Pants], cannot be after [Peter Pants]
Plague Brass         - cannot be before [Ghost Ichor, Peter Pants], cannot be after [Peter Pants]
Red Blossom          - cannot be before [Peter Pants], cannot be after [Bloat Cabbage, Peter Pants]
Roc Oil              - cannot be before [Behemoth Claw, Peter Pants], cannot be after [Peter Pants]
Satyr Tear           - cannot be before [Peter Pants], cannot be after [Peter Pants]
Serpent Feather      - cannot be before [Minotaur Hair, Peter Pants], cannot be after [Luminous Broadleaf, Peter Pants]
Shadow Bronze        - cannot be before [Peter Pants], cannot be after [Fatal Brick, Peter Pants]
Sphinx Tear          - cannot be before [Peter Pants], cannot be after [Tengu Sweat, Peter Pants]
Tengu Sweat          - cannot be before [Sphinx Tear, Peter Pants], cannot be after [Peter Pants]
Werewolf Essence     - cannot be before [Peter Pants], cannot be after [Bugbear Extract, Peter Pants]
Wolpertinger Fang    - cannot be before [Peter Pants], cannot be after [Peter Pants]
Wyvern Flesh         - cannot be before [Cerberus Collar, Peter Pants], cannot be after [Peter Pants]
Wyvern Liver         - cannot be before [Cerberus Collar, Peter Pants], cannot be after [Peter Pants]
Yeti Fur             - cannot be before [Ogre Snot, Peter Pants], cannot be after [Peter Pants]